####################00000000000
#p  f          *  1#00000000000
# # # #*#*# # # #  #00000000000
#  b  *  2*  * *   #00000000000
# # # # 2 # # # #  ############
#s    *   ** 2 1 * #          #
# # # #*#*# # # # # # # # # # #
#        *   * * #            #
########### # # # # # # # # # #
0000000000##      1       2   #
0000000000# # # # # # # # # # #
0000000000#         2   x     #
0000000000#####################