###############################
#p  f  ** *  1 * 2 *  * * *   #
# # # #*# # #*#*# # # #*#*#*# #
#  b*     ***  *  1   * 2 * * #
# # # # # #*# # #*#*# # # # #*#
#s         x **  *  *   1     #
# # # # # # # # # #*# #*# # # #
#*  *      *  *      *        #
# # # # #*# # # #*#*# # # # # #
#*    **  *       *           #
# #*# # # # # # #*# # # # # # #
#           *   *  *          #
###############################